NO ./path_to_the_n   orth_texture
SO ./path_to_the_s   outh_texture
WE ./path_to_the  _west_texture
EA ./pat     h_to_the_east_text ure

F  0, 255, 2


C    7, 3,0        




     1111 
       
       1
1                
        1111111111111111111111111
       1000000000110000000000001
        1011000001110000000000001
        1001000000000000000000001
11111111011000001110000000000001
100000000011000001110111111111111
11110111111111011100000010001
11110111111111011101001010001
11000000110101011100000010001
1000000000000000110000N0010001
10000000000000001101010010001
110000011101010111110111100111
1110111 1110101 101111010001
11111111 1111111 1111111111111