NO ./assets/wall.xpm
SO ./assets/wall1.xpm
EA ./assets/wall2.xpm
WE ./assets/wall3.xpm

F 0,0,0
C 5,77,20

 
1111111
1000001
1000W01
1111111