
NO ./path_to_the_north_texture
SO ./path_to_the_south_texture
WE ./path_to_the_west_texture
EA ./path_t         o_the_east_texture

F       224        ,2,255
C                             225,3,0

111111111111111111111111111111111
111111111000000000110000000000001
111111111011000001110000000000001
111111111001000000000000000000001
111111110110000011100000000000011
100000000011000001110111111111111
111101111111110111010010100011111
100000000000000011000000100011111
100000000N00000011000000100011111
100000000000000110101001000111111
110000011101010111110111100111111
1110111 1110101 10111101000111111
11111111 1111111 1111111111111111