NO ./assets/wall.xpm
SO ./assets/wall1.xpm
EA ./assets/wall2.xpm
WE ./assets/wall3.xpm

F 220,100,0
C 225,30,0
111111111111111111111111111
100000000000000000000000001
100001000000000000000000001
100000100000000000000000001
100000000000010000000000001
100000000000000000000000001
100000000000000000000000001
10000001111111100111100W001
111111111111111111111111111