NO ./assets/wall.xpm
SO ./assets/wall1.xpm
EA ./assets/wall2.xpm
WE ./assets/wall3.xpm

F 0,0,0
C 5,77,20

    111111111111111111111111111
    100000000000000000000000001
    100001000000000000000000001
1111110000010000000000000000001
1000000000000100000000000011111
100000000000000000000000001
100000000000000000000000001
10000001111111100111100N001
111111111111111111111111111