NO ./assets/wall.xpm
SO ./assets/wall1.xpm
EA ./assets/wall2.xpm
WE ./assets/wall3.xpm



F 5,0,0
C  26, 35, 126
11111111111111111111111111
1011111111111111111111111111
1111011111111111111111111111111
11110111111111N111111100011111
10000000000000000000000001
11111111111111111111111111